abandon=ละทิ้ง
accept,admit=ยอมรับ
affection=ความรัก
afraid=กลัว
against=ต้าน,พิง
agree=ตกลง,เห็นด้วย
ahead=ข้างหน้า,เบื้องหน้า
allow=อนุญาต
beat=เอาชนะ
becalm=ทำให้สงบ,บรรเทา
befool=ล่อลวง,หลอก,ทำให้โง่
behavior=ความประพฤติ
bicycle=จักรยาน
brittle=เปราะ
build=สร้าง
bury=ฝัง
capacity=ความสามารถ,ความจุ
carry=ถือ
certain=แน่นอน
cessation=การหยุด
coexist=อยู่ร่วมกัน
commodity=สินค้า
compensate=ชดเชย
cooperate=ยอมทำตาม,ร่วมมือ
declare=ประกาศ
decode=ถอดรหัส
decrease=ลด
defeat=พ่ายแพ้
defend=ป้องกัน
deny=ปฏิเสธ
depend on=ขึ้นอยู่กับ
destroy=ทำลาย
ease=บรรเทา
efflux=การไหลออก
eject=ขับไล่
escape=หลบหนี
especially=โดยเฉพาะ
establish=สร้าง
excessive=มากเกิน
ant=มด
ant=แมว
