factor=ปัจจัย
famine=ทุพภิกขภัย
flexible=ที่ยืดหยุ่น
fluent=คล่อง
force=บังคับ
foremost=สำคัญสุด,หน้าสุด
fortress=ป้อมปราการ
function=หน้าที่
gamble=การพนัน
garbage=ขยะ
generation=ยุคสมัย
genetic=ที่ให้กำเนิด
geology=ธรณีวิทยา
gimmick=กลเม็ด
global=ทั่วโลก
gloom=ความเศร้าโศก
habitat=ที่อยู่อาศัย
handicap=แต้มต่อ
haunting=ที่อยู่ในความทรงจำ
heed=เอาใจใส่
hemisphere=ซีกโลก
heterology=ความผิดปกติ
homology=ภาวะที่คล้ายคลึงกัน
honest=ซื่อสัตย์
identify=ระบุ,ชี้ตัว
illegal=ผิดกฎหมาย
illness=ความเจ็บป่วย
inactive=เฉื่อย
income=เงินเดือน,รายได้
infect=ติดเชื้อ
infer=สรุป
inferior=ด้อยกว่า
jail=คุก
jeopardize=เป็นอันตราย
jewel=เพชรพลอย
journal=วารสาร,หนังสือพิมพ์
judge=ตัดสิน,ผู้พิพากษา
junction=ชุมทาง,จุดเชื่อมต่อ
just=ยุติธรรม,เพิ่งจะ
justify=ให้เหตุผล
