keep=เก็บ,รักษา
kick=ถีบ,เตะ
kidney=ไต
kind=ชนิด,ประเภท,ใจดี
kinenematic=จลนศาสตร์
knight=อัศวิน
knock=เคาะ,ทุบ
knowledge=ความรู้
labor,labour=แรงงาน
lack=ขาดแคลน
lamp=โคมไฟ
lap=เกย,เหลื่อม
legal=ที่ถูกกฎหมาย
long for=ปราถนา
lurid=น่ากลัว
luxury=ความหรูหรา
magnet=แม่เหล็ก
mainly=ส่วนใหญ่
maintenance=การบำรุงรักษา
medley=ผสมปนเป
method=วิธี
mimic=ล้อเลียน
mobile=ที่เคลื่อนที่ได้
mysterious=มหัศจรรย์
naked=เปลือย,ล่อนจ้อน
neglect=ทอดทิ้ง,ละเลย
nevertheless=อย่างไรก็ตาม
nominee=ตัวแทน,หุ่นเชิด
notable=ที่มีชื่อเสียง
notify=ประกาศ
nuke=นิวเคลียร์
nutrition=โภชนาการ 
oblique=ลาด,เอียง
oblivious=ที่ลืม
obscure=มืดมน,ปิดบัง
observe=สังเกต
offhand=ไม่ได้ไตร่ตรอง
onion=หัวหอม
opportunity=โอกาส
oppose=คัดค้าน
