palace=พระราชวัง
passive=เฉื่อย
pavement=บาทวิถี
pearl=ไข่มุก
perceive=รู้เข้าใจ
philanthropy=ใจบุญ
pipe=ท่อ
ponder=ครุ่นคิด
quake=สั่น,ไหว
quality=คุณภาพ
quantity=ปริมาณ
quarrel=ทะเลาะ
queer=ประหลาด,พิลึก
quell=ปราบปราม
quit=เลิก
quote=อ้าง
rail=รางรถไฟ
rare=ที่หายาก
rational=ความมีเหตุผล
reform=ปฏิรูป
rejoice=ยินดี,รื่นเริง
relieve=บรรเทา
remedy=การเยียวยารักษา
riddle=ปริศนา
salute=สรรเสริญ,คำนับ
saturate=อิ่มตัว
scholar=ทุนการศึกษา,นักเรียนทุน
self-assured=ที่มั่นใจตัวเอง
sentiment=ความรู้สึก
skeleton=โครงกระดูก
slothful=เฉื่อย
soothe=บรรเทา
take_part_in=เข้าร่วม
temper=อ่อนลง,บรรเทาลง
temporary=ชั่วคราว
terror=ความกลัว
theory=ทฤษฎี
thrill=น่าตื่นเต้น
tolerate=อดทน,ยอมทน
trial=การทดลอง
