undergo=ประสบ
understand=เข้าใจ
unique=พิเศษ,หนึ่งเดียว
unwrap=แกะ(สิ่งของ)
upgrade=เพิ่มขึ้น
upset=ทำให้เสียใจ
useful=มีประโยชน์
utmost=สุดกำลัง,อย่างที่สุด
vacation=วันหยุด
varied=แตกต่างกัน
vase=แจกัน
vehicle=ยานพาหนะ
verity=ความจริง
verse=บทกลอน
violent=รุนแรง
vital=จำเป็น
wagon=เกวียน
wander=ร่อนเร่ไป
wanted=ประกาศจับ
warn=เตือน
warrant=รับประกัน
waste=สูญเปล่า,ของเสีย
whistle=นกหวีด,ผิวปาก
witness=พยาน
xenon=ธาตุซีนอน
xenophile=คนที่นิยมชมชอบชาวต่างชาติ
xenophobe=คนที่กลัวชาวต่างชาติ
xerox=ถ่ายเอกสาร
Xmas=คริสต์มาส
x-ray=การฉายรังสีx
xylem=ท่อน้ำของพืช
xylophone=ระนาด
yard=หลา
yell=ตะโกน
yellow=สีเหลือง
yet=ยัง
yield=ยอม,ให้ผลผลิต
yokel=คนบ้านนอก
youth=วัยหนุ่มสาว
yummy=เอร็ดอร่อย
zany=ตัวตลก
zebra=ม้าลาย
zero=ศูนย์
zipper=ซิป (เช่น ซิปเสื้อ ซิปกระเป๋า)
zippy=กระตือรือร้น
zone=เขต,ภาค,ส่วน
zoo=สวนสัตว์
zoom=ซูม,ขยายภาพให้ชัด
